{
  "width": 1216,
  "height": 1088,
  "gridCellWidth": 64,
  "gridCellHeight": 64,
  "gridCellsX": 30,
  "gridCellsY": 35,
"Level": [
    {
      "name": "TestLevel2",
      "_eid": "45510701",
      "LevelData": [
        [0, 0, 0, 0, 0, 0, 0, 0, 0, 0, 0, 0, 0, 0, 0, 0, 0, 0, 0, 0, 0, 0, 0, 0, 0, 0, 0, 0, 0, 0],
        [0, 0, 0, 0, 0, 0, 0, 0, 0, 0, 0, 0, 0, 0, 0, 0, 0, 0, 0, 0, 0, 0, 0, 0, 0, 0, 0, 0, 0, 0],
        [0, 0, 0, 0, 0, 0, 0, 3, 3, 3, 3, 3, 3, 3, 0, 0, 0, 0, 0, 0, 0, 0, 0, 0, 0, 0, 0, 0, 0, 0],
        [0, 0, 0, 0, 0, 3, 3, 3, 1, 1, 1, 1, 1, 1, 1, 1, 1, 1, 0, 0, 0, 0, 0, 0, 0, 0, 0, 0, 0, 0],
        [0, 0, 0, 0, 3, 3, 1, 1, 1, 1, 1, 1, 1, 1, 1, 1, 1, 1, 1, 1, 1, 1, 0, 0, 0, 0, 0, 0, 0, 0],
        [0, 0, 0, 0, 3, 1, 1, 1, 1, 1, 1, 1, 1, 1, 4, 1, 1, 1, 1, 4, 1, 1, 1, 1, 0, 0, 0, 0, 0, 0],
        [0, 0, 0, 0, 3, 1, 1, 1, 1, 3, 3, 1, 1, 1, 1, 1, 1, 1, 1, 1, 1, 1, 1, 1, 0, 0, 0, 0, 0, 0],
        [0, 0, 0, 0, 3, 1, 1, 1, 3, 0, 0, 3, 1, 1, 1, 1, 1, 1, 1, 1, 1, 1, 1, 1, 1, 0, 0, 0, 0, 0],
        [0, 0, 0, 3, 3, 1, 1, 1, 3, 0, 0, 3, 1, 1, 1, 1, 1, 0, 0, 1, 1, 1, 1, 1, 1, 0, 0, 0, 0, 0],
        [0, 0, 0, 3, 1, 1, 1, 1, 1, 0, 0, 3, 1, 1, 1, 1, 1, 0, 0, 0, 1, 1, 4, 1, 1, 0, 0, 0, 0, 0],
        [0, 0, 3, 3, 1, 1, 1, 1, 1, 3, 3, 1, 1, 1, 1, 1, 3, 0, 0, 0, 0, 1, 1, 1, 0, 0, 0, 0, 0, 0],
        [0, 0, 3, 1, 1, 1, 4, 1, 1, 1, 1, 1, 1, 1, 1, 3, 3, 0, 0, 0, 0, 0, 1, 0, 0, 0, 0, 0, 0, 0],
        [0, 0, 3, 1, 1, 1, 1, 1, 1, 1, 1, 1, 1, 1, 1, 3, 0, 0, 0, 0, 0, 0, 0, 0, 0, 0, 0, 0, 0, 0],
        [0, 0, 3, 1, 1, 1, 1, 1, 1, 1, 1, 1, 4, 1, 3, 3, 0, 0, 0, 0, 0, 0, 0, 0, 0, 0, 0, 0, 0, 0],
        [0, 0, 3, 3, 1, 1, 1, 1, 1, 1, 1, 1, 1, 1, 3, 3, 0, 0, 0, 0, 0, 0, 0, 0, 0, 0, 0, 0, 0, 0],
        [0, 0, 0, 3, 3, 1, 1, 1, 1, 1, 1, 1, 1, 1, 1, 3, 0, 0, 0, 0, 0, 0, 0, 0, 0, 0, 0, 0, 0, 0],
        [0, 0, 0, 0, 3, 3, 1, 1, 2, 1, 1, 1, 1, 1, 1, 3, 3, 3, 3, 0, 0, 0, 0, 0, 0, 0, 0, 0, 0, 0],
        [0, 0, 0, 0, 0, 3, 1, 1, 1, 1, 1, 1, 1, 1, 1, 1, 1, 3, 3, 3, 0, 0, 0, 0, 0, 0, 0, 0, 0, 0],
        [0, 0, 0, 0, 0, 3, 3, 1, 1, 1, 1, 1, 1, 1, 1, 1, 1, 1, 1, 3, 3, 3, 0, 0, 0, 0, 0, 0, 0, 0],
        [0, 0, 0, 0, 0, 0, 3, 1, 1, 1, 1, 1, 1, 1, 1, 1, 1, 1, 1, 1, 1, 3, 0, 0, 0, 0, 0, 0, 0, 0],
        [0, 0, 0, 0, 0, 0, 3, 3, 1, 1, 1, 1, 1, 1, 1, 1, 1, 1, 1, 1, 1, 3, 0, 0, 0, 0, 0, 0, 0, 0],
        [0, 0, 0, 0, 0, 0, 0, 3, 3, 1, 1, 1, 1, 2, 1, 1, 1, 1, 1, 1, 1, 3, 3, 0, 0, 0, 0, 0, 0, 0],
        [0, 0, 0, 0, 0, 0, 0, 0, 3, 3, 3, 1, 1, 1, 1, 1, 1, 1, 1, 1, 1, 1, 3, 3, 0, 0, 0, 0, 0, 0],
        [0, 0, 0, 0, 0, 0, 0, 0, 0, 0, 3, 3, 1, 1, 1, 1, 1, 1, 1, 1, 1, 1, 1, 3, 3, 0, 0, 0, 0, 0],
        [0, 0, 0, 0, 0, 0, 0, 0, 0, 0, 3, 3, 3, 1, 1, 1, 1, 1, 1, 1, 1, 1, 1, 3, 3, 0, 0, 0, 0, 0],
        [0, 0, 0, 0, 0, 0, 0, 0, 0, 0, 3, 3, 3, 3, 1, 1, 1, 1, 1, 2, 1, 1, 1, 3, 3, 0, 0, 0, 0, 0],
        [0, 0, 0, 0, 0, 0, 0, 0, 0, 3, 3, 1, 1, 1, 1, 1, 1, 1, 1, 1, 1, 1, 1, 3, 3, 0, 0, 0, 0, 0],
        [0, 0, 0, 0, 0, 0, 0, 0, 0, 3, 1, 1, 1, 1, 1, 1, 1, 1, 1, 1, 1, 1, 3, 3, 3, 0, 0, 0, 0, 0],
        [0, 0, 0, 0, 0, 0, 0, 0, 0, 3, 1, 1, 1, 1, 1, 1, 1, 1, 1, 1, 1, 3, 3, 3, 0, 0, 0, 0, 0, 0],
        [0, 0, 0, 0, 0, 0, 0, 0, 0, 3, 1, 1, 1, 1, 1, 1, 1, 1, 1, 3, 3, 3, 0, 0, 0, 0, 0, 0, 0, 0],
        [0, 0, 0, 0, 0, 0, 0, 0, 0, 3, 1, 1, 1, 1, 5, 1, 1, 1, 1, 3, 3, 3, 0, 0, 0, 0, 0, 0, 0, 0],
        [0, 0, 0, 0, 0, 0, 0, 0, 0, 3, 3, 1, 1, 1, 1, 1, 1, 1, 1, 3, 3, 0, 0, 0, 0, 0, 0, 0, 0, 0],
        [0, 0, 0, 0, 0, 0, 0, 0, 0, 0, 3, 3, 1, 1, 1, 1, 1, 3, 3, 3, 3, 0, 0, 0, 0, 0, 0, 0, 0, 0],
        [0, 0, 0, 0, 0, 0, 0, 0, 0, 0, 0, 3, 3, 3, 3, 3, 3, 3, 3, 3, 0, 0, 0, 0, 0, 0, 0, 0, 0, 0],
        [0, 0, 0, 0, 0, 0, 0, 0, 0, 0, 0, 0, 0, 0, 0, 0, 0, 0, 0, 0, 0, 0, 0, 0, 0, 0, 0, 0, 0, 0]
      ]
    }
  ],
    
"CoreEntities": [
    {
      "name": "Core",
      "_eid": "60951797",
      "entities": [
        {
          "name": "CoreEntity",
          "id": 0,
          "_eid": "76875843",
          "x": 896,
          "y": 1920,
          "originX": 0,
          "originY": 0,
          "values": {"ObjectID": 0, "CoreHealth": 1000, "CoreTargetData": 2000}
        }
      ]
    }
  ],
    
"EnemySpawnerEntities": [
{
      "name": "EnemySpawners",
      "_eid": "67570941",
      "entities": [
        {
          "name": "EnemySpawner",
          "id": 0,
          "_eid": "67564834",
          "x": 1408,
          "y": 576,
          "originX": 0,
          "originY": 0,
          "values": {"ObjectID": 1, "EnemySpawnType": 0, "EnemySpawnDelay": 0.6}
        },
        {
          "name": "EnemySpawner",
          "id": 1,
          "_eid": "67564834",
          "x": 1216,
          "y": 320,
          "originX": 0,
          "originY": 0,
          "values": {"ObjectID": 2, "EnemySpawnType": 2, "EnemySpawnDelay": 0.3}
        },
        {
          "name": "EnemySpawner",
          "id": 2,
          "_eid": "67564834",
          "x": 384,
          "y": 704,
          "originX": 0,
          "originY": 0,
          "values": {"ObjectID": 3, "EnemySpawnType": 1, "EnemySpawnDelay": 0.75}
        },
        {
          "name": "EnemySpawner",
          "id": 4,
          "_eid": "67564834",
          "x": 896,
          "y": 320,
          "originX": 0,
          "originY": 0,
          "values": {"ObjectID": 0, "EnemySpawnType": 2, "EnemySpawnDelay": 0.6}
        },
        {
          "name": "EnemySpawner",
          "id": 5,
          "_eid": "67564834",
          "x": 768,
          "y": 832,
          "originX": 0,
          "originY": 0,
          "values": {"ObjectID": 2, "EnemySpawnType": 0, "EnemySpawnDelay": 0.4}
        }
      ]
    }
],
    
"TowerEntities": [
{
      "name": "Towers",
      "_eid": "67570941",
      "entities": [
        {
          "name": "TowerEntity",
          "id": 2,
          "_eid": "60977868",
          "x": 1216,
          "y": 1600,
          "originX": 0,
          "originY": 0,
          "values": {"ObjectID": 25, "BulletType": 85, "TowerHealth": 150, "FireRate": 0.3}
        },
        {
          "name": "TowerEntity",
          "id": 3,
          "_eid": "60977868",
          "x": 512,
          "y": 1024,
          "originX": 0,
          "originY": 0,
          "values": {"ObjectID": 20, "BulletType": 82, "TowerHealth": 175, "FireRate": 0.4}
        },
        {
          "name": "TowerEntity",
          "id": 4,
          "_eid": "60977868",
          "x": 832,
          "y": 1344,
          "originX": 0,
          "originY": 0,
          "values": {"ObjectID": 27, "BulletType": 83, "TowerHealth": 300, "FireRate": 0.2}
        }
      ]
    }
]
}